13 15
111111111111111
100000200000001
101111110001101
101111110001101
101111100001101
100020000011101
101111100011101
101111100011101
101111102011101
101111000011101
101111000011111
100000000000021
111111111111111
5
1 1
6 8