11 11
11111111111
10002000001
10111101101
10111101101
10111001101
10111211101
10111011101
10110011101
10110011101
10020000001
11111111111
4
1 8
9 1
