***********
*   o    S*
* **** ** *
* **** ** *
* ***  ** *
* ***o*** *
* *** *** *
* **  *** *
* **  *** *
*P o      *
***********
